*********
****.  P*
**** ** *
****.**.*
**** ** *
*.  .  .*
*********