*********
****.  P*
**** ** *
****.**.*
**** ** *
*.  G  .*
*********