*********
*******P*
******* *
******* *
******* *
*.      *
*********