********
*P     *
* .* . *
*  *  o*
* .* . *
*     G*
********
