*******
* P  .*
* ***.*
*o.G .*
*******

